Richard Shelby	r
Doug Jones	d
Lisa Murkowski	r
Dan Sullivan	r
Jeff Flake	r
Jon Kyl	r
John Boozman	r
Tom Cotton	r
Dianne Feinstein	d
Kamala Harris	d
Michael Bennet	d
Cory Gardner	r
Richard Blumenthal	d
Chris Murphy	d
Tom Carper	d
Chris Coons	d
Bill Nelson	d
Marco Rubio	r
Johnny Isakson	r
David Perdue	r
Brian Schatz	d
Mazie Hirono	d
Mike Crapo	r
Jim Risch	r
Dick Durbin	d
Tammy Duckworth	d
Joe Donnelly	d
Todd Young	r
Chuck Grassley	r
Joni Ernst	r
Pat Roberts	r
Jerry Moran	r
Mitch McConnell	r
Rand Paul	r
Bill Cassidy	r
John Kennedy	r
Susan Collins	r
Angus King	i
Ben Cardin	d
Chris Van Hollen	d
Elizabeth Warren	d
Ed Markey	d
Debbie Stabenow	d
Gary Peters	d
Amy Klobuchar	d
Tina Smith	d
Roger Wicker	r
Cindy Hyde-Smith	r
Claire McCaskill	d
Roy Blunt	r
Jon Tester	d
Steve Daines	r
Deb Fischer	r
Ben Sasse	r
Dean Heller	r
Catherine Cortez Masto	d
Jeanne Shaheen	d
Maggie Hassan	d
Bob Menendez	d
Cory Booker	d
Tom Udall	d
Martin Heinrich	d
Chuck Schumer	d
Kirsten Gillibrand	d
Richard Burr	r
Thom Tillis	r
John Hoeven	r
Heidi Heitkamp	d
Sherrod Brown	d
Rob Portman	r
Jim Inhofe	r
James Lankford	r
Ron Wyden	d
Jeff Merkley	d
Bob Casey Jr.	d
Pat Toomey	r
Jack Reed	d
Sheldon Whitehouse	d
Lindsey Graham	r
Tim Scott	r
John Thune	r
Mike Rounds	r
Lamar Alexander	r
Bob Corker	r
John Cornyn	r
Ted Cruz	r
Orrin Hatch	r
Mike Lee	r
Patrick Leahy	d
Bernie Sanders	i
Mark Warner	d
Tim Kaine	d
Patty Murray	d
Maria Cantwell	d
Joe Manchin	d
Shelley Moore Capito	r
Ron Johnson	r
Tammy Baldwin	d
Mike Enzi	r
John Barrasso	r
Jeff Sessions	r
Al Franken	d
Luther Strange	r
Thad Cochran	r
John McCain	r